1111111111111PCE11111111111111