111111111111111
111111111111111
111111111111111
11111000CCC1111
1111101111C1111
111C101111C1111
1P00000C00000E1
111111111111111